%%%%%%%
%P  % %
%%%   %
% %.. %
% %%. %
% .GG.%
%%%%%%%