%%%%%%%
%P .%.%
%.%.  %
%   % %
% % % %
% .  G%
%%%%%%%