%%%%%%%
%P% o.%
%.. % %
% . o %
% .%%.%
%  GGG%
%%%%%%%