%%%%%%%
%P ...%
% % o %
% .   %
% %.%.%
% o GG%
%%%%%%%