%%%%%%%%%%%
%P. %o  . %
%  .. %.%.%
% %  .  % %
% %% %.%% %
% ..... % %
%%%%.%% o %
%. o .%.% %
% . %%   .%
% %.  G G.%
%%%%%%%%%%%