%%%%%%%%%%%
%P%.   ...%
% %.%.    %
% % %.%   %
% %.%. .% %
% % .   %o%
% %%%.% %.%
%   %... .%
%%  o%%%  %
%  Go.G G.%
%%%%%%%%%%%