%%%%%%%%%%%
%P    %.  %
%%%%% %  .%
%  .%.  % %
% % %%% % %
%.%...%   %
% % %  %% %
%.. .   % %
% %.  %%% %
% G %.G. G%
%%%%%%%%%%%