%%%%%%%%%%%
%P%  ...  %
%  % %  % %
%  .%     %
%%% %.%%. %
%o%.    ..%
% % %%% % %
% %.  . % %
% % %  % .%
%   %oG...%
%%%%%%%%%%%