%%%%%%%%%%%
%P. %.    %
%% .  %%% %
% %.   . .%
%  % %%% .%
%.%   .   %
% % %%% % %
%.%. .. ..%
% % % % % %
% . . % .G%
%%%%%%%%%%%