%%%%%%%%%%%
%P.   % ..%
%%.%% . % %
%.    . % %
%   %.  % %
%. .%.  %.%
% %%. %%  %
%  .% %  .%
%   %o%%% %
%      G G%
%%%%%%%%%%%