%%%%%%%%%%%
%P .  . ..%
%%%  %%   %
%   . . % %
%.. . %%. %
% %   %  .%
%  .%%. %.%
%...% ..% %
%   % %  .%
% % . G .G%
%%%%%%%%%%%