%%%%%%%%%%%%%%%%%%%
%P .%. . .. ....  %
%%%.%%% %%%.% %%%%%
% %   %     %     %
% %.%.o. % %%  .. %
%.    %... .. . % %
% %%%%%%%%%%%%%.% %
%. . ...    o %.%.%
%    %% %.%.% .  .%
%  .  %.%   %.  % %
% %%%...% % %%% . %
%.  o.  %o      %.%
% ..%   % % % . %.%
% % % %.. % %.%   %
% . . .%  %    %% %
%  .%. .% % % % . %
%   . %%%  % .G %%%
%.%..G. ..G. .%G G%
%%%%%%%%%%%%%%%%%%%