%%%%%%%%%%%%%%%%%%%
%P .% . %..       %
%%% %.%.% %%%.%.%.%
%  .. % %.  .     %
% %%% % %%% %.%%%o%
%      ...      % %
%.  %%% % %%.%% % %
% %    .% %  .%o% %
%.%%%   % % % % % %
%. .  %     %   % %
%  ..%%%. %.%%  % %
% %   ... %   %   %
%  %%%  ..  % %   %
%.  ..%.. % % ..  %
% %%%. % %%.  %%  %
%. . .   .. % %.  %
% %%   %%%%...    %
%       G G G G. G%
%%%%%%%%%%%%%%%%%%%