%%%%%%%%%%%%%%%
%P% ..     ...%
% %.%%%%..  % %
%. .% ....% %.%
%%.%. %%%.. %%%
%   . %  .. . %
% %. %%%% . %.%
% %     %.  %.%
% %%% . %% %% %
%.%. .. ..%.  %
%.%.  %%% %.  %
%  .% o %   % %
%.%%%% .%% %%.%
%..   GoG. GoG%
%%%%%%%%%%%%%%%