%%%%%%%%%%%%%%%
%P .%... .% . %
%%%  ..%% % . %
%   % ..% . % %
% %.%  .%%. % %
%  .. % % ..  %
% %% ... .%o% %
%   . % . %   %
%.%%%.  % %  .%
% %   .   ..%.%
% %%%  %% %%%.%
%.o .   % . % %
%%%.% . %%..o %
% . G ..%G G G%
%%%%%%%%%%%%%%%