%%%%%%%%%%%%%%%
%P      %    .%
%   %.  ..%%% %
%   % % %.%. .%
%.%%    %. .%.%
%   .   %   % %
%%%%% .   %%  %
% %  .. %   % %
% %.%% %%%%%  %
%   % ..     .%
% %  %%%% %% %%
%.. % .      .%
%.%%% % % %% .%
%     %. . G G%
%%%%%%%%%%%%%%%