%%%%%%%%%%%%%%%
%P%  .%  . . .%
%.% % %%%%% %%%
%       . %.  %
% %.% %  . .% %
%.  .    .% % %
% % %%.%% %%%.%
% %   %.  % . %
%.  %.   %% %.%
%.  %.%     . %
%%  . % % %%% %
%.    %. ...  %
% %%%%% %%% % %
%. G.. G. %.G.%
%%%%%%%%%%%%%%%