%%%%%%%%%%%%%%%
%P% .       ..%
% % %%%%%  %% %
% ..%   % ....%
%.% %.%.%%.%% %
% %  .o %   %.%
%  %%   %..   %
%  .  %   ..% %
% % % %. %  % %
%   .   ... % %
%.%.%.% % % % %
% %        .% %
% % %. .% . . %
%   G ..G.% .G%
%%%%%%%%%%%%%%%