%%%%%%%%%%%%%%%
%P  %..    o .%
%%% . % % %%  %
%o% %.  %  .% %
%.% ..% %%% ..%
% ..% %       %
% %%%% %% %   %
% %.  ..  % o %
% % % . %%%%%.%
% % %. .% o.% %
%  .%%.%.   % %
%   %  .o o ..%
% % %.% % %. .%
% GoG ...G G..%
%%%%%%%%%%%%%%%