%%%%%%%%%%%%%%%
%P    . . %   %
%%%   % . %   %
%..  .. %   % %
%.. %. %%.    %
%. .....%..  .%
% %%% %.% %%%.%
% . ..     ...%
%  % %%.%%%  .%
% %.. .. .    %
% %.     %.%% %
%   % %..   ..%
%% % .   %.%% %
%      .. GGGG%
%%%%%%%%%%%%%%%