%%%%%%%%%%%%%%%
%P... % .  .  %
%%% %  ..% %% %
% % %. o   .  %
% %o%%%%. % %%%
%...%o.   % ..%
% %%% % %%%%%.%
%   % .  .. . %
% % %.% .   % %
%.   .%. .. . %
%.%%.%%.% % %%%
% .    .%   %.%
%oo%. %   %%% %
% ... %G G ..G%
%%%%%%%%%%%%%%%