%%%%%%%%%%%%
%P         %
% . .      %
%          %
% . .      %
%     . .  %
%        G %
%    . .   %
%          %
%  . .     %
%         G%
%%%%%%%%%%%%