%%%%%%%
% P   %
%     %
%  .  %
%     %
%  G  %
%%%%%%%
